10 10
XXXXXXXXXX
XG       X
XXXXX    X
X        X
X  XXXXXXX 
X        X
X    X   X
X    X   X
X    X   X
XXXXXXXXXX