10 10
XXXXXXXXXX
X        X
X        X
X        X
XXXXX    X
X        X
X    XXXXX
X    XX GX
X        X
XXXXXXXXXX